1111111111111111111111111
100000000110P000000000001
1111100000000000000000001
1000000000E00000000000001
1000000000000000000C00001
1000000000000000000000001
1000000000000000000000001
1111111111111111111111111